spring break in mexico	spring break in mexico
coyote fox	coyote fox
herbergers	herberger s	herbergers
where is the sentinel node	where is the sentinel node
efavirenz	efavirenz
capt bryan willard	capt bryan willard
sanctions	sanctions
conan obrien show	conan o brien show
cng	cng
i discovered the four moons of saturn	i discovered the four moons of saturn
business malaysia	business malaysia
dwayne lowe	dwayne lowe
unemployment rate in the great depression	unemployment rate in the great depression
sam sloat	sam sloat
village of mineola ny	village of mineola ny
colostomy management	colostomy management
neyo time instrumental	neyo time instrumental	ne yo time instrumental
working couples	working couples
san isidro costa rica	san isidro costa rica
galesville maryland	galesville maryland
kpdk	kpdk
sacramento ca	sacramento ca
vasomotor symptoms	vasomotor symptoms
rubber metal seal	rubber metal seal
indian bend park	indian bend park
bumps in mouth	bumps in mouth	bump in mouth
north carolina hazmat	north carolina hazmat
9th circut court	9th circuit court
the big read	the big read
usgs real time water data	usgs real time water data
cummins	cummins
centro medico paitilla	centro medico paitilla
government auditing standards	government auditing standards
poker	poker
commercial propane grill	commercial propane grill
tax returns online	tax returns online
footballhalloffame	football hall of fame
bend oregon newspaper	bend oregon newspaper
salary employees	salary employees
outlook express	outlook express
doug scofield	doug scofield
simple search	simple search
horror scopes	horrorscopes	horoscopes	horrorscope
child disability	child disability
fafsa financial aid	fafsa financial aid
white girls	white girls	white girl
taxable pensions	taxable pensions
6 or 7 passenger suv	6 or 7 passenger suv
powerball results	powerball results
trailer manifest box	trailer manifest box
